########
#......#
#.##.#.#
#......#
########