##############
#.....O......#
#.M...o....M.#
#............#
#....####&&&&#
#............#
#............#
#............#
#......i.....#
##############