#########L####
#.....C......#
#.E........E.#
#............#
#....####....#
#............#
#............#
#............#
#......P.....#
##############