##############
#..........iI#
#..s...#######
#...........a#
#######......#
#......M.....#
#Oo....#S....#
#......M.....#
#h...........#
##############