##############
#.........P..#
#......#######
#............#
#######......#
#C.....E.....#
L......#E....#
#......E.....#
#............#
##############