##############
#............#
#............#
#............#
#.....#......#
#............#
#......#.....#
#............#
#............#
##############