##############
#H$.......O..#
#$........o..#
#.....S#.....#
#............#
#.....S#.....#
#Ii..........#
#.....M#.....#
#............#
##############