##########L###
#CE..........#
#E...........#
#.....E#.....#
#............#
#.....E#.....#
#P...........#
#.....E#.....#
#............#
##############