##############
#..........iI#
#.......######
#$$$######..O#
#...###.....o#
#...#....S...#
#.M.##.......#
#.......#M...#
#......S....H#
##############