##############
#............#
#.......#....#
#...#........#
#............#
#............#
#....#.......#
#.......#....#
#............#
##############