##############
#.........P..#
#.......######
#EEE######...L
#...###......#
#...#........#
#.E.##.......#
#.......#EE..#
#......E....C#
##############