##############
#............#
#............#
#....#..#....#
#............#
#...#....#...#
#............#
#.....#......#
#............#
##############