##############
#....EEEE....#
#.E..........#
#...##...#####
#.E.#.L..#...#
#...#....#..P#
#.E.#CCC##...#
#E..######...#
#.E.E........#
##############