##############
#....B.......#
#.M.......S..#
#...##...#####
#...#....#..I#
#...#..o.#..i#
#...###O.#...#
#...######...#
#z..$........#
##############